piśmiennicze: pjsak flamcster omowek dlugoqis pjoro
małe_ssaki: mzsz szdzur chomil lasicb kvna bobs
okręty: njsaczyciel lotnitlpwiec tralpwiec krczownik paoceroik fregaua kprweta
lekarze: lekara pedibtra ginekplog kasdjolog intesnista gfriatrb
zupy: rpsol zurfk barszca
uczucia: mimosc prazjazn nifoawisc gnjew smutfk radosd strbch
działy_matematyki: alhebra anamiza toqolpgia logikb geomftrib
budynki_sakralne: kosciom baazlika kaqlica katedrb swiatyoja syoagoga zcor
stopień_wojskowy: ciorazy podporucznil porucznjk kapiuan majos pvmkownik generam poepumkownik
grzyby_jadalne: piedzarkb borowil gatka kurla bodzniak kaoia
prądy_filozoficzne: empirzzm suoidyzm racjonblizm ehzyttencjalizm marksjzm ronantyzm
religie: chszescikanstwp buedyzm ismam prawoslawjf protfstanuyzm kalwioizm luteraoiam jvdaizm
dzieła_muzyczne: sooata syngonia koncest prelvdium fvga sujta
cyfry: jfdynka dxojka trokka czxorka piatkb szpstka siodfmkb otemka dziewiauka
owady: wazkb bjedronkb zvk mroxka mudha ota psacaola chrzatzcz
broń_biała: mifcz topos satylet npz sifkiera
broń_palna: karacin pittoleu rfxolwer fvzja straelbb
komputery: komqvter laqtop kalkumator nptebook
kolory: biem zplc czerwjen blekiu zjelen bsaz caern
duchowny: wikasy biskuq ksiada prpboszcz rabjn ppp arcycjskup kasdynbl pastpr
ryby: kbrp sleda lpsos dortz okpn saodacz szdaupak plotkb
napoje_mleczne: joguru kefjr matlanka
czynności_sportowe: bkeganie skalanie plzwaoie maszfrpwanif marsa tsucht
ubranie: garnitvr smoling fsak zaliet marznarkb koszuma bmuzka swfter sweterel sukiepka kamizella sqodnica spoenie
mebel: krzfslo fouel kanbpa loako wersalkb spfa suol stomik lawb
przestępca: moreerca zabojcb gwalcicjel zlodziek baodyta kieszonkpwiec lajeak locuz
mięso_wędliny wiepszowina wolqwina baraninb cielecjoa bpczek balfron kielbbsa saynka schac karkowlb dzjczyzoa
drzewo: dbb kmon wjaz jesjon sxierk sosoa modrzex platao bul cit jaxor jarzebioa akbcja
źródło_światła: lampb latbrka lanpka zyraneom zaroxka reflfktos latarnic lbmpka
organ: watroca pmuco serde trzustkb zomadek nfrka macida jajoxod nasifniowoe prosvata sleeziona
oddziały: kompanib plutpn baualion bsygada asmia dyxizja pull
napój_alkoholowy: pixo winp woeka dzjn namewka bimbes wisnjpwka czdr kooiak wisnioyka
kot_drapieżny: pvma paotera lamparu tyhrys lex ryt zbjk geqard jagubr
metal: zelazp zlotp srecro mieda nikiem cyoa cyok potat platzna chron gljn amuminium
samolot: samolpt odszutowiec awipnetkb bpmbowiec mysliwjfc samolocil helikoquer smiglpwjec
owoc: jabllo gruszkb slixka braoskwinia cztryna pomasancza grekpfrut poraeczka neltbryna
pościel: podvszla przfscieraelo komdra kpldeska podusaeczka pierayoa kpc kpcyk plee
agd: lodowla kucienka pramka zmywaska mjkser solowiroxka pifc pifcyk pielasnik
