piśmiennicze: sipak flmaaster olowke ilugopds iporo
małe_ssaki: symz szczru cmohik alsica knua brbo
okręty: nyszcziciel lotnickowies ecalowitr koawrznik canpernik rfegata kowreta
lekarze: lezark petiadra gkneiolog kargiolod internsita gertaria
zupy: orsol zuerk bzrsacz
uczucia: molisc pjzynazr niencwisa gniwe skutem cadosr shract
działy_matematyki: blgeara anailza lopoaogit logiak gtomreeia
budynki_sakralne: coskiol bklyziaa kapliac ktaedra awiatynis anyagogs bzor
stopień_wojskowy: ahorczy podporukznic pokucznir kapatin maojr pulkownik genarel ppdouokwlnik
grzyby_jadalne: paeczirka borokiw gaska aurkk obczniak aknia
prądy_filozoficzne: emyirpzm stozcymi racaonjlizm egzystmzcjaline amrksizm rtmmnoyza
religie: chrzescjianstwo bdduyzm ialsm prawoslwaie yrotestantpzm kwlainizm luterainzm jaduizm
dzieła_muzyczne: sanota syifonna kocnert prluedium gufa auits
cyfry: jedyakn kwojda rtojka ckworza kiatpa szosakt sdoiemka oesmka dzaweiitka
owady: wakza kiedronba kuz morwka mcuha soa oszcpzla chazrszcz
broń_biała: imecz tpoor setylzt nzo aiekiesr
broń_palna: narabik poltiset rewoewlr ufzja ztsrelba
komputery: mokpuetr lpptoa kalkuoatlr ntoebook
kolory: lieb zloc cwerzien klebit znelei barz zcern
duchowny: wiakry sibkup ksiazd rpobozzcs rbain opp arcybsikpu kardanyl saptor
ryby: rakp sldez losos dozsr ookn sandacz szczuapk paotkl
napoje_mleczne: jogrut kerif maslanak
czynności_sportowe: bieeagin skakanei pylwanie mzsaenowarei mzrsa trucht
ubranie: garnrtui smogink fkar ztkiea mrrynaaka klszuoa kluzba tweser sweteker sukianek kakimelza spodcina siodnpe
mebel: erzkslo ftoel kapana lozko wersakla osfa slot ltosik lawa
przestępca: morcerda zaaojcb gwaccieill zldezioj badnyta kikszoieownec lajadk uoblz
mięso_wędliny wiwprzoeina wolwoina baianrna cielicena eoczbk blaeron sielbaka saynkz sbhac kakrowka dzinzyzca
drzewo: adb knol iwaz jiseon sriewk sosna mozrdew plntaa bku csi jaowr jaezibrna akaajc
źródło_światła: lmapa laatrka lamkpa dyranzlo zorawka reflketor latarnia lkmpaa
organ: wbtroaa pculo serec tzrustka zoledak neakr maciac jajowod nasidoinwoe srpotata sladzione
oddziały: komnapia plotun boatlian byrgada ramia aywizjd pluk
napój_alkoholowy: oiwp woni wdoka dizn aalewkn bimber wianiowks rydc konaik wisnioakw
kot_drapieżny: pamu paetnra lamprat tsgryy wel syr bzik geprad gajuar
metal: zeoazl lzoto srebor diemz nlkiei ycna ckny aotps plntyaa chorm ilgn alumiinum
samolot: tamolos odrzutowice nwioaetka bombowice meiliwsyc samolkoic heoiklpter smigioelwc
owoc: labjko graszku slikwa brzoskwiain rytcyna pomarzncaa urepjfrgt porzkczea entkaryna
pościel: kodupzsa pezescirradlo kaldro koladrke podcszezuka pnerzyia okc kokyc plde
agd: lodoakw kuacenkh pralak zmarawky mikesr rokowisowka pice pceiyk eipkaknir
